########
#@     #
# $$$  #
# ...  #
#      #
########