#######
#@    #
# $  .#
# $  .#
#     #
#######