#########
#@      #
# $$$   #
# ...   #
#   $   #
#   .   #
# $$    #
# ..    #
#########