##########
#@       #
# $   $  #
# .   .  #
#   $    #
#   .    #
# $   $  #
# .   .  #
##########