########
#@     #
#  $   #
#  .   #
#    $ #
#    . #
# $  . #
########