########
#@     #
# $  $ #
# .  . #
#      #
# $  $ #
# .  . #
########