######
#@.  #
# $  #
#    #
# $. #
######