########
#@     #
# $$   #
# ..   #
# $$   #
# ..   #
#      #
########