##########
#@       #
# $$$    #
#   #    #
#   #    #
#   ...  #
##########